%%%%%%%%%%%%%%%%%%%%%
%                   %
%                   %
%                   %
%                   %
%                   %
%                   %
%                   %
%P                  %
%.                  %
%%%%%%%%%%%%%%%%%%%%%
