%%%%%%%%%%%%%%%%%%%%%
%                   %
%                   %
%                   %
%                   %
%          P        %
%                   %
%                   %
%                   %
%.                  %
%%%%%%%%%%%%%%%%%%%%%
