%%%%%%%%%%%%%%%%%%%%%
%                   %
%              P    %
%                   %
%                   %
%                   %
%                   %
%                   %
%                   %
%.                  %
%%%%%%%%%%%%%%%%%%%%%
