%%%%%%%%%%%%%%%%%%%%%
%                   %
%                   %
%                   %
%                   %
%                   %
%                   %
%                   %
%                   %
%.                 P%
%%%%%%%%%%%%%%%%%%%%%
