%%%%%%%%%%%%%%%%%%%%%
%                   %
%                   %
%                   %
%                   %
%                   %
%                   %
%                   %
%                   %
%. P                %
%%%%%%%%%%%%%%%%%%%%%
