%%%%%%%%%%%%%%%%%%%%%
%                   %
%                   %
%                   %
%                   %
%                   %
%                   %
%P                  %
%                   %
%.                  %
%%%%%%%%%%%%%%%%%%%%%
