%%%%%%%%%%%%%%%%%%%%%
%           P       %
%                   %
%                   %
%                   %
%                   %
%                   %
%                   %
%                   %
%.                  %
%%%%%%%%%%%%%%%%%%%%%
