%%%%%%%%%%%%%%%%%%%%%
%                   %
% P                 %
%                   %
%                   %
%                   %
%                   %
%                   %
%                   %
%.                  %
%%%%%%%%%%%%%%%%%%%%%
