%%%%%%%%%%%%%%%%%%%%%
%                   %
%                   %
%                   %
%                   %
%                   %
%                   %
%                   %
%                   %
%.P                 %
%%%%%%%%%%%%%%%%%%%%%
