%%%%%%%%%%%%%%%%%%%%%
%                   %
%                   %
%                   %
%                   %
%               P   %
%                   %
%                   %
%                   %
%.                  %
%%%%%%%%%%%%%%%%%%%%%
