%%%%%%%%%%%%%%%%%%%%%
%                   %
%                   %
%                   %
%                   %
%                   %
%                   %
%                   %
%      P            %
%.                  %
%%%%%%%%%%%%%%%%%%%%%
