%%%%%%%%%%%%%%%%%%%%%
%                   %
%                   %
%                   %
%                   %
%                   %
%                   %
%                   %
%                  P%
%.                  %
%%%%%%%%%%%%%%%%%%%%%
