%%%%%%%%%%%%%%%%%%%%%
%                   %
%                   %
%                   %
%                   %
%                   %
%                   %
%                   %
%           P       %
%.                  %
%%%%%%%%%%%%%%%%%%%%%
