%%%%%%%%%%%%%%%%%%%%%
%                   %
%                   %
%                   %
%                   %
%                   %
%                  P%
%                   %
%                   %
%.                  %
%%%%%%%%%%%%%%%%%%%%%
