%%%%%%%%%%%%%%%%%%%%%
%                   %
%                   %
%                   %
%                   %
%                   %
%                   %
%                   %
%   P               %
%.                  %
%%%%%%%%%%%%%%%%%%%%%
