%%%%%%%%%%%%%%%%%%%%%
%                   %
%                   %
%                   %
%                   %
%                   %
%        P          %
%                   %
%                   %
%.                  %
%%%%%%%%%%%%%%%%%%%%%
