%%%%%%%%%%%%%%%%%%%%%
%                   %
%    P              %
%                   %
%                   %
%                   %
%                   %
%                   %
%                   %
%.                  %
%%%%%%%%%%%%%%%%%%%%%
