%%%%%%%%%%%%%%%%%%%%%
%                   %
%                   %
%                   %
%                   %
%  P                %
%                   %
%                   %
%                   %
%.                  %
%%%%%%%%%%%%%%%%%%%%%
