%%%%%%%%%%%%%%%%%%%%%
%                   %
%                   %
%             P     %
%                   %
%                   %
%                   %
%                   %
%                   %
%.                  %
%%%%%%%%%%%%%%%%%%%%%
