%%%%%%%%%%%%%%%%%%%%%
%                   %
%       P           %
%                   %
%                   %
%                   %
%                   %
%                   %
%                   %
%.                  %
%%%%%%%%%%%%%%%%%%%%%
