%%%%%%%%%%%%%%%%%%%%%
%              P    %
%                   %
%                   %
%                   %
%                   %
%                   %
%                   %
%                   %
%.                  %
%%%%%%%%%%%%%%%%%%%%%
