%%%%%%%%%%%%%%%%%%%%%
%                   %
%                   %
%                   %
%                   %
%                   %
%                   %
%                 P %
%                   %
%.                  %
%%%%%%%%%%%%%%%%%%%%%
