%%%%%%%%%%%%%%%%%%%%%
%                   %
%                   %
%                   %
%                   %
%                   %
%      P            %
%                   %
%                   %
%.                  %
%%%%%%%%%%%%%%%%%%%%%
