%%%%%%%%%%%%%%%%%%%%%
%      P            %
%                   %
%                   %
%                   %
%                   %
%                   %
%                   %
%                   %
%.                  %
%%%%%%%%%%%%%%%%%%%%%
