%%%%%%%%%%%%%%%%%%%%%
%                   %
%            P      %
%                   %
%                   %
%                   %
%                   %
%                   %
%                   %
%.                  %
%%%%%%%%%%%%%%%%%%%%%
