%%%%%%%%%%%%%%%%%%%%%
%                   %
%                   %
%                P  %
%                   %
%                   %
%                   %
%                   %
%                   %
%.                  %
%%%%%%%%%%%%%%%%%%%%%
