%%%%%%%%%%%%%%%%%%%%%
%     P             %
%                   %
%                   %
%                   %
%                   %
%                   %
%                   %
%                   %
%.                  %
%%%%%%%%%%%%%%%%%%%%%
