%%%%%%%%%%%%%%%%%%%%%
%                   %
%                   %
%                   %
%                   %
%                   %
%                   %
%                   %
%                   %
%.              P   %
%%%%%%%%%%%%%%%%%%%%%
