%%%%%%%%%%%%%%%%%%%%%
%                   %
%                   %
%                   %
%                   %
%                   %
%                   %
%                   %
%                 P %
%.                  %
%%%%%%%%%%%%%%%%%%%%%
