%%%%%%%%%%%%%%%%%%%%%
%                   %
%                   %
%                   %
%                   %
%                   %
%                   %
%                   %
%                   %
%.             P    %
%%%%%%%%%%%%%%%%%%%%%
