%%%%%%%%%%%%%%%%%%%%%
%                   %
%                   %
%                   %
%                   %
%                   %
%                   %
%                   %
%                   %
%.         P        %
%%%%%%%%%%%%%%%%%%%%%
