%%%%%%%%%%%%%%%%%%%%%
%                   %
%                   %
%                   %
%                   %
%           P       %
%                   %
%                   %
%                   %
%.                  %
%%%%%%%%%%%%%%%%%%%%%
