%%%%%%%%%%%%%%%%%%%%%
%                   %
%         P         %
%                   %
%                   %
%                   %
%                   %
%                   %
%                   %
%.                  %
%%%%%%%%%%%%%%%%%%%%%
