%%%%%%%%%%%%%%%%%%%%%
%   P               %
%                   %
%                   %
%                   %
%                   %
%                   %
%                   %
%                   %
%.                  %
%%%%%%%%%%%%%%%%%%%%%
