%%%%%%%%%%%%%%%%%%%%%%%%
%           %          %
%         % %%%        %
%      %%%    %%%      %
%    %%%        %%%    % 
%  %%%   %%  %%   %%%  %
% %%%%%%%%%  %%%%%%%%%%%
%  %%%   %%%%%%   %%%  %
%P         %%   %%%    %
%      %%%    %        %
%%%%%%%%%%%%%%%%%%%% %%%
%   %   %   %          %
% % % % % % %          %
%.%   %   %            %
%%%%%%%%%%%%%%%%%%%%%%%%
