%%%%%%%%%%%%%%%%%%%%%%%%
%           %          %
%         % %%%        %
%      %%%    %%%      %
%    %%%        %%%    % 
%  %%%   %%  %%   %%%  %
% %%%%%%%%%  %%%%%%%%%%%
%  %%%   %%%%%%   %%%  %
%          %%   %%%    %
%      %%%    %        %
%%%%%%%%%%%%%%%%%%%% %%%
% P %   %   %          %
% % % % % % %          %
%.%   %   %            %
%%%%%%%%%%%%%%%%%%%%%%%%
