%%%%%%%%%%%%%%%%%%%%%
%                   %
% %%%%%%%% %%%%%%%% %
% %               % %
% % %%%%%% %%%%%% % %
% % %           % % %
% % % %%%% %%%% % % %
% % % %       % % % %
% % % %       % % % %
% % % %       % % % %
% % % %       % % % %
% % % %       % % % %
% % % %%%% %%%% % % %
% % %           % % %
% % %%%%%% %%%%%% % %
% %               % %
% %%%%%%%% %%%%%%%% %
%. P                %
%%%%%%%%%%%%%%%%%%%%%
