%%%%%%%%%%%%%%%%%%%%%
%                   %
% %%%%%%%% %%%%%%%% %
% %               % %
% % %%%%%% %%%%%% % %
% % %           % % %
% % % %%%% %%%% % % %
% % % %       % % % %
% % % %       % % % %
% % % %       % % % %
% % % %       % % % %
% % % %       % %P% %
% % % %%%% %%%% % % %
% % %           % % %
% % %%%%%% %%%%%% % %
% %               % %
% %%%%%%%% %%%%%%%% %
%.                  %
%%%%%%%%%%%%%%%%%%%%%
