%%%%%%%%%%%%%%%%%%%%%%
% %%        % %      %
%    %%%%%%P% %%%%%% %
%%%%%%        %      %
%    % %%%%%% %% %%%%%
% %%%% %         %   %
%        %%% %%%   % %
%%%%%%%%%%    %%%%%% %
%.         %%        %
%%%%%%%%%%%%%%%%%%%%%%
