%%%%%%%%%%%%%%%%%%%%%%
% %%        % %      %
%    %%%%%% % %%%%%% %
%%%%%%        %      %
% P  % %%%%%% %% %%%%%
% %%%% %         %   %
%        %%% %%%   % %
%%%%%%%%%%    %%%%%% %
%.         %%        %
%%%%%%%%%%%%%%%%%%%%%%
