%%%%%%%%%%%%%%%%%%%%%%
% %%        % %      %
%  P %%%%%% % %%%%%% %
%%%%%%        %      %
%    % %%%%%% %% %%%%%
% %%%% %         %   %
%        %%% %%%   % %
%%%%%%%%%%    %%%%%% %
%.         %%        %
%%%%%%%%%%%%%%%%%%%%%%
