%%%%%%%%
%     G%
%G%%%%%%
%.   P %
%%%%%%%%
