%%%%%%%%
%    PG%
%G%%%%%%
%.     %
%%%%%%%%
