%%%%%%%%
% P   G%
%G%%%%%%
%.     %
%%%%%%%%
