%%%%%%%%%%%%%%%%%%%%
%              %   %
% %% %% %% %% %% % %
%                % %
%%%%%%%%%%%%%%%%%% %
%    P             %
%%%%%%%%%%%%%%%%%% %
%                  %
%              %   %
% %% %% %% %% %% % %
%                % %
%%%%%%%%%%%%%%%%%% %
%.                 %
%%%%%%%%%%%%%%%%%%%%
