%%%%%%%%%%%%%%%%%%%%
%              %   %
% %% %% %% %% %% % %
%                % %
%%%%%%%%%%%%%%%%%% %
%                  %
%%%%%%%%%%%%%%%%%% %
%      P           %
%              %   %
% %% %% %% %% %% % %
%                % %
%%%%%%%%%%%%%%%%%% %
%.                 %
%%%%%%%%%%%%%%%%%%%%
